21
11
13 0 0 0 0 0 0 0 0 0 0 0 0 0 0 0 0 0 0 0 13  
12 0 0 0 0 0 0 0 0 0 0 0 0 0 0 0 0 0 0 0 12
12 0 0 0 0 0 0 0 0 0 0 0 0 0 0 0 0 0 0 0 12
12 0 0 0 0 0 0 0 0 0 0 0 0 0 0 0 0 0 0 0 12
12 0 0 0 0 0 0 0 0 0 0 0 0 0 0 0 0 0 0 0 12
12 0 0 0 0 0 0 0 0 0 0 0 7 8 9 0 0 0 0 0 12
12 0 0 0 0 0 0 0 7 8 9 0 0 0 0 0 0 0 0 0 12
12 0 0 0 0 0 0 0 0 0 0 0 0 0 0 0 0 0 0 0 12
12 0 0 0 0 0 0 0 0 0 0 0 0 0 0 0 0 0 0 0 12
7 8 8 8 8 8 8 8 8 8 8 8 8 8 8 8 8 8 8 8 9 0
0 0 0 0 0 0 0 0 0 0 0 0 0 0 0 0 0 0 0 0 0 0

